*8********  ***
* ****     ****
* ****   *    X 
*      ****  **
**** * *     **
*    * * *** **
****** * *** **
*      * *** **
* ******     **
*        ******
*****    *** **
*****   **** **
***   ***    **
***       *****
***************
