*8*************
* ****  *******
* ****   **   X
*      ****  **
**** * *     **
*    * * *** **
****** * *** **
*      * *** **
* ******     **
*        ******
*****    ******
*****   *******
***   *********
***  **********
***************
