*8*************
* *************
*        ******
**** * * ******
*    * * ******
****** * ******
*      * ******
* *************
*        ******
********X******
