*8*************
* *************
*         *****
**** * * ******
*    * * ******
****** * ******
*      * ******
* *************
* *************
*        ******
****     ******
****** * ******
****** * ******
****** ********
*        ******
********X******
